#########
#E#S    #
# #######
# # ### #
#       #
#########