#########
#E#     #
# ###S# #
# ##### #
#       #
#########